1111111111111
100100000CC01
1000011111001
1P0000E000101
1111111111111